acl	modificador de oração do substantivo (oração adjetiva)
advcl	modificador de cláusula adverbial
advmod	modificador adverbial
amod	modificador de adjetivo
appos	modificador aposicional
aux	auxiliar
case	marcação de caixa
cc	conjunção coordenativa
ccomp	complemento da oração
clf	classificador
compound	composto
conj	conjunct
cop	copula
csubj	sujeito da oração
dep	dependência não especificada
det	determinador
discourse	discourse element
dislocated	dislocated elements
expl	expletive
fixed	fixed multiword expression
flat	flat multiword expression
goeswith	goes with
iobj	objeto indireto
list	lista
mark	marcador
NOUN	substantivo
nmod	nominal modifier
nsubj	sujeito nominal
nummod	numeric modifier
obj	objeto
obl	nominal oblíquo
orphan	orphan
parataxis	parataxis
punct	pontuação
reparandum	overridden disfluency
ROOT	raíz
vocative	vocativo
xcomp	open clausal complement
AUX	auxiliar
VERB	verbo
DET	determinador
PRON	pronome
NOUN	substantivo